1 2 8

1 1 1 1 1 1 1 1
1 1 0 0 0 0 1 1
1 1 0 0 0 0 1 1
0 0 0 0 0 0 0 0
0 0 0 0 0 0 0 0
1 7 0 0 0 0 7 1
1 1 0 0 0 0 1 1
1 1 7 0 0 7 1 1

1 1 1 1 1 1 1 1
1 1 0 0 0 0 1 1
1 1 0 0 0 0 1 1
0 0 0 0 0 0 0 0
0 0 0 0 0 0 0 0
1 7 1 0 0 1 0 1
1 1 1 0 0 1 7 1
1 1 1 1 1 1 1 1