1 2 16

1 1 1 1 1 1 0 0 0 1 1 1 1 1 1 1
0 0 1 1 1 1 0 0 0 1 1 1 1 4 0 0
0 0 0 0 4 4 0 0 0 0 0 0 0 0 0 0
0 0 0 0 0 0 0 5 0 0 0 0 0 0 0 0
0 0 0 0 0 0 0 0 0 0 0 0 0 0 0 0
0 0 0 0 0 0 0 0 0 0 0 2 1 2 0 0
1 1 1 1 1 1 1 1 1 1 1 1 1 1 1 1
1 1 1 1 1 1 1 1 1 1 1 1 1 1 1 1

1 1 1 1 1 1 0 0 0 1 1 1 1 1 1 1
0 0 1 4 4 1 0 0 0 1 1 4 1 4 0 0
0 0 0 0 6 0 0 0 0 0 0 0 0 0 0 0
0 0 0 0 0 0 0 0 0 0 0 0 0 0 0 0
0 0 0 0 0 0 0 0 0 0 0 0 0 0 0 0
0 0 0 0 0 0 0 0 0 0 0 2 1 2 0 0
1 1 0 0 0 1 1 1 0 0 4 1 1 1 1 1
1 1 1 1 1 1 1 1 1 1 1 1 1 1 1 1