1 1 16

1 1 1 1 1 1 1 1 1 1 1 1 1 1 1 1
1 4 1 1 1 1 4 4 4 1 1 1 1 4 4 1
0 0 0 0 4 4 0 0 0 0 0 4 4 0 0 0
0 0 0 0 0 0 7 7 0 0 0 0 0 0 0 0
0 0 0 0 0 0 0 0 0 0 0 0 0 0 0 0
0 7 7 0 0 0 0 0 0 0 0 7 7 7 7 7
1 1 1 1 1 1 0 0 0 0 1 1 1 1 1 1
1 1 1 1 1 1 1 1 1 1 1 1 1 1 1 1